111111111111
122002112101
121010000001
102011100101
101022000201
100011212011
101200022001
100221012101
121111002201
110102011011
102201100001
111111111111